30,16
############################################################
##                                                        ##
##                                                        ##
##                                                        ##
##                                                        ##
## - - - - - - -                                          ##
##                                                        ##
##                                                        ##
##                                                       ###
##                                                     # ###
##. . . . . . . . . . . . . . . . . . . . . . .#.#.#.#.#.###
##. . .#. .#. . . . . . . . . . . . . . . . .#.#.#.#.#.#.###
##. .#. . . .#. . . . . . . . . . . . . . .#. . . .#. . . ##
##. .#.W.W.W.#. . . . . . . . . . . . . .#. . . . .#. . . ##
##. .#.W.W.W.#. . . . . . . . . . . . .#. . . . . .#. . . ##
#######################T#T##################################
#tiles/art/dirt_01.png
.tiles/grass.png
-tiles/rope.png
Wtiles/water.png
Ttiles/trampoline.png

