40,26
################################################################################
##. .             . . . . . . . . . . . . . . . . . .                         ##
##. . .             . . . . . . . . . .         . .                           ##
##. . . .             . . . . . . . . .         . .                           ##
##. . . .             . . . . . . . . .          # #                          ##
## # # # #            . . . . . . . . .                                       ##
## # # # #           # # # # # # # # # #                                      ##
##. .                # # # # # # # # # #                                      ##
##. .            # # # # # # # # # # # # # #                                  ##
##. . .          # # # # # # # # # # # # # #            . ## # # #            ##
##. . .           . . . . .#.#.#.#. . . . .           . . ## # # #            ##
##. . .           . . . . .#.#.#.#. . . . .         . . . ## # # #            ##
##.#.#.#          . . . . . . . . . . . . .         .#.#.# # # #.             ##
##.#.#.#        . . . . . . . . . . . . . .     . . .#.#.# # #. .             ##
##.#.#.#        . . . . . . . . . . . . . . . . . . .#.#.# #. . .             ##
############################################################. .          # # ###
############################################################. .        # # # ###
########.#.#.#.#.#. . . . . . . . . . . . . . . .#.#.#.#.#. .          # # # ###
########.#.#. . . . . . . . . . . . . . . . . . . . .#.#. .              # # ###
########.#. . . . . . . . . . . . . . . . . . . . . . . . .               . .###
########. . . . . . . . . . . . . . . . . . . . . . . . .                   .###
########. . . . . . . . . . . . . . . . . . . . . . . . .                 . .###
########. . . . . . . . . . . . . . . . . . . . . . . . . .              # # ###
########. . . . . . . . . . . . . . . . . . . . . . . . . . .# # # # # # # # ###
########. . . . . . . . . . . . . . . . . . . . . . . . .#.# # # # # # # # # ###
################################################################################
#tiles/art/dirt_01.png
#tiles/art/dirt_02.png
#tiles/art/dirt_03.png
#tiles/art/dirt_04.png
#tiles/art/dirt_05.png
#tiles/art/dirt_06.png
#tiles/art/dirt_07.png
.tiles/grass.png
-tiles/rope.png
Wtiles/water.png

